AthleteID: swimmer1	Athlete Name: Doretta Estela	Score:0
AthleteID: swimmer2	Athlete Name: Clark Charlott	Score:0
AthleteID: swimmer3	Athlete Name: Adolfo Raymun	Score:0
AthleteID: swimmer4	Athlete Name: Hugo Timmy	Score:0
AthleteID: swimmer5	Athlete Name: Alda Lavonda	Score:0
AthleteID: swimmer6	Athlete Name: Marie Casie	Score:0
AthleteID: swimmer7	Athlete Name: Hyo Landon	Score:0
AthleteID: swimmer8	Athlete Name: Mui Ardath	Score:0
AthleteID: cyclist1	Athlete Name: Lannie Janie	Score:0
AthleteID: cyclist2	Athlete Name: Ervin Lynn	Score:0
AthleteID: cyclist3	Athlete Name: Lorenzo Nubia	Score:0
AthleteID: cyclist4	Athlete Name: Temple Dannie	Score:5
AthleteID: cyclist5	Athlete Name: Yvonne Micaela	Score:1
AthleteID: cyclist6	Athlete Name: Kasey Britni	Score:0
AthleteID: cyclist7	Athlete Name: Brandie Otilia	Score:2
AthleteID: cyclist8	Athlete Name: Fawn Charisse	Score:0
AthleteID: sprinter1	Athlete Name: Samatha Earle	Score:0
AthleteID: sprinter2	Athlete Name: Dalila Armanda	Score:0
AthleteID: sprinter3	Athlete Name: Rusty Alesha	Score:0
AthleteID: sprinter4	Athlete Name: Piper Pauline	Score:0
AthleteID: sprinter5	Athlete Name: Brandee Katrina	Score:0
AthleteID: sprinter6	Athlete Name: Logan Cecilia	Score:0
AthleteID: sprinter7	Athlete Name: Shu Rubie	Score:0
AthleteID: sprinter8	Athlete Name: Theodore Nicole	Score:0
AthleteID: superAthlete1	Athlete Name: Jorge Titus	Score:0
AthleteID: superAthlete2	Athlete Name: Verlene Providen	Score:0
AthleteID: superAthlete3	Athlete Name: Nery Jon	Score:0
AthleteID: superAthlete8	Athlete Name: Jeanine Wilfredo	Score:0
